Phrase,Word Count,Character Count,Phrase Without Spaces,Consonants,Consonants Count,Vowels Count
Take care of the pennies and the pounds will take care of themselves,13,68,takecareofthepenniesandthepoundswilltakecareofthemselves,tkcrfthpnnsndthpndswlltkcrfthmslvs,34,34
Sticks and stones may break my bones but words will never hurt me,13,65,sticksandstonesmaybreakmybonesbutwordswillneverhurtme,stcksndstnsmybrkmybnsbtwrdswllnvrhrtm,37,28
It is no use locking the stable door after the horse has bolted,13,63,itisnouselockingthestabledoorafterthehorsehasbolted,tsnslckngthstbldrftrthhrshsbltd,31,32
There are more ways of killing a cat than choking it with cream,13,63,therearemorewaysofkillingacatthanchokingitwithcream,thrrmrwysfkllngctthnchkngtwthcrm,32,31
Better to have loved and lost than never to have loved at all,13,61,bettertohavelovedandlostthannevertohavelovedatall,bttrthvlvdndlstthnnvrthvlvdtll,30,31
One half of the world does not know how the other half lives,13,60,onehalfoftheworlddoesnotknowhowtheotherhalflives,nhlffthwrlddsntknwhwththrhlflvs,31,29
The only disability in life is a bad attitude Scott Hamilton,11,60,theonlydisabilityinlifeisabadattitudescotthamilton,thnlydsbltynlfsbdtttdsctthmltn,30,30
Laugh and the world laughs with you weep and you weep alone,12,59,laughandtheworldlaughswithyouweepandyouweepalone,lghndthwrldlghswthywpndywpln,28,31
Those who do not learn from history are doomed to repeat it,12,59,thosewhodonotlearnfromhistoryaredoomedtorepeatit,thswhdntlrnfrmhstryrdmdtrptt,28,31
History repeats itself and it does not care what it repeats,11,59,historyrepeatsitselfanditdoesnotcarewhatitrepeats,hstryrptstslfndtdsntcrwhttrpts,30,29
You can lead a horse to water but you cannot make it drink,13,58,youcanleadahorsetowaterbutyoucannotmakeitdrink,ycnldhrstwtrbtycnntmktdrnk,26,32
Hunger never knows the taste sleep never knows the comfort,10,58,hungerneverknowsthetastesleepneverknowsthecomfort,hngrnvrknwsthtstslpnvrknwsthcmfrt,33,25
He who fights and runs away may live to fight another day,12,57,hewhofightsandrunsawaymaylivetofightanotherday,hwhfghtsndrnswymylvtfghtnthrdy,30,27
What the eye does not see the heart does not grieve over,12,56,whattheeyedoesnotseetheheartdoesnotgrieveover,whtthydsntsthhrtdsntgrvvr,25,31
Everybody wants to go to heaven but nobody wants to die,11,55,everybodywantstogotoheavenbutnobodywantstodie,vrybdywntstgthvnbtnbdywntstd,28,27
What you lose on the swings you gain on the roundabouts,11,55,whatyouloseontheswingsyougainontheroundabouts,whtylsnthswngsygnnthrndbts,26,29
People who live in glass houses should not throw stones,10,55,peoplewholiveinglasshousesshouldnotthrowstones,pplwhlvnglsshssshldntthrwstns,29,26
A journey of a thousand miles begins with a single step,7,55,a journey ofa thousand milesbeginswithasinglestep, jrny f thsnd mlsbgnswthsnglstp,31,24
All is for the best in the best of all possible worlds,12,54,allisforthebestinthebestofallpossibleworlds,llsfrthbstnthbstfllpssblwrlds,29,25
It is better to light a candle than curse the darkness,11,54,itisbettertolightacandlethancursethedarkness,tsbttrtlghtcndlthncrsthdrknss,29,25
No one can make you feel inferior without your consent,10,54,noonecanmakeyoufeelinferiorwithoutyourconsent,nncnmkyflnfrrwthtyrcnsnt,24,30
Those who live in glass houses should not throw stones,10,54,thosewholiveinglasshousesshouldnotthrowstones,thswhlvnglsshssshldntthrwstns,29,25
You cannot run with the hare and hunt with the hounds,11,53,youcannotrunwiththehareandhuntwiththehounds,ycnntrnwththhrndhntwththhnds,28,25
Better to light one candle than to curse the darkness,10,53,bettertolightonecandlethantocursethedarkness,bttrtlghtncndlthntcrsthdrknss,29,24
If you lie down with dogs you will get up with fleas,12,52,ifyouliedownwithdogsyouwillgetupwithfleas,fyldwnwthdgsywllgtpwthfls,25,27
In the kingdom of the blind the one eyed man is king,12,52,inthekingdomoftheblindtheoneeyedmanisking,nthkngdmfthblndthnydmnskng,26,26
Ask a silly question and you will get a silly answer,11,52,askasillyquestionandyouwillgetasillyanswer,sksllyqstnndywllgtsllynswr,26,26
To travel hopefully is a better thing than to arrive,10,52,totravelhopefullyisabetterthingthantoarrive,ttrvlhpfllysbttrthngthntrrv,27,25
March comes in like a lion and goes out like a lamb,12,51,marchcomesinlikealionandgoesoutlikealamb,mrchcmsnlklnndgstlklmb,22,29
If you cannot stand the heat get out of the kitchen,11,51,ifyoucannotstandtheheatgetoutofthekitchen,fycnntstndthhtgttfthktchn,25,26
What is sauce for the goose is sauce for the gander,11,51,whatissauceforthegooseissauceforthegander,whtsscfrthgssscfrthgndr,23,28
The best-laid schemes of mice and men often go awry,10,51,thebest-laidschemesofmiceandmenoftengoawry,thbst-ldschmsfmcndmnftngwry,27,24
Success has many fathers while failure is an orphan,9,51,successhasmanyfatherswhilefailureisanorphan,sccsshsmnyfthrswhlflrsnrphn,27,24
Life is too short not to do something that matters,10,50,lifeistooshortnottodosomethingthatmatters,lfstshrtnttdsmthngthtmttrs,26,24
Never put off until tomorrow what you can do today,10,50,neverputoffuntiltomorrowwhatyoucandotoday,nvrptffntltmrrwwhtycndtdy,25,25
The more things change the more they stay the same,10,50,themorethingschangethemoretheystaythesame,thmrthngschngthmrthystythsm,27,23
A place for everything and everything in its place,9,50,aplaceforeverythingandeverythinginitsplace,plcfrvrythngndvrythngntsplc,27,23
Do not count your chickens before they are hatched,9,50,donotcountyourchickensbeforetheyarehatched,dntcntyrchcknsbfrthyrhtchd,26,24
Do not sympathize with those who can not empathize,9,50,donotsympathizewiththosewhocannotempathize,dntsympthzwththswhcnntmpthz,27,23
One might as well be hanged for a sheep as a lamb,12,49,onemightaswellbehangedforasheepasalamb,nmghtswllbhngdfrshpslmb,23,26
Do unto others as you would have them do unto you,11,49,dountoothersasyouwouldhavethemdountoyou,dntthrssywldhvthmdnty,21,28
There is many a good tune played on an old fiddle,11,49,thereismanyagoodtuneplayedonanoldfiddle,thrsmnygdtnplydnnldfddl,23,26
You catch more flies with honey than with vinegar,9,49,youcatchmoreflieswithhoneythanwithvinegar,yctchmrflswthhnythnwthvngr,26,23
You cannot make an omelette without breaking eggs,8,49,youcannotmakeanomelettewithoutbreakingeggs,ycnntmknmlttwthtbrkngggs,24,25
A Lark bird in the hand is worth two in the bush,12,48,alarkbirdinthehandisworthtwointhebush,lrkbrdnthhndswrthtwnthbsh,25,23
A man with a hammer sees every problem as a nail,11,48,amanwithahammerseeseveryproblemasanail,mnwthhmmrssvryprblmsnl,22,26
He who lives by the sword shall die by the sword,11,48,hewholivesbytheswordshalldiebythesword,hwhlvsbythswrdshlldbythswrd,27,21
The innocent seldom find an uncomfortable pillow,7,48,theinnocentseldomfindanuncomfortablepillow,thnncntsldmfndnncmfrtblpllw,27,21
There is none so blind as those who will not see,11,48,thereisnonesoblindasthosewhowillnotsee,thrsnnsblndsthswhwllnts,23,25
An ounce of prevention is worth a pound of cure,10,47,anounceofpreventionisworthapoundofcure,nncfprvntnswrthpndfcr,21,26
Give a man rope enough and he will hang himself,10,47,giveamanropeenoughandhewillhanghimself,gvmnrpnghndhwllhnghmslf,23,24
It is better to travel hopefully than to arrive,9,47,itisbettertotravelhopefullythantoarrive,tsbttrttrvlhpfllythntrrv,24,23
They that sow the wind shall reap the whirlwind,9,47,theythatsowthewindshallreapthewhirlwind,thythtswthwndshllrpthwhrlwnd,28,19
Genius is an infinite capacity for taking pains,8,47,geniusisaninfinitecapacityfortakingpains,gnssnnfntcpctyfrtkngpns,23,24
Keep your friends close and your enemies closer,8,47,keepyourfriendscloseandyourenemiescloser,kpyrfrndsclsndyrnmsclsr,23,24
Lightning never strikes twice in the same place,8,47,lightningneverstrikestwiceinthesameplace,lghtnngnvrstrkstwcnthsmplc,26,21
If a job is worth doing it is worth doing well,11,46,ifajobisworthdoingitisworthdoingwell,fjbswrthdngtswrthdngwll,23,23
The bread never falls but on its buttered side,9,46,thebreadneverfallsbutonitsbutteredside,thbrdnvrfllsbtntsbttrdsd,24,22
The hand that rocks the cradle rules the world,9,46,thehandthatrocksthecradlerulestheworld,thhndthtrcksthcrdlrlsthwrld,27,19
The road to Hell is paved with good intentions,9,46,theroadtohellispavedwithgoodintentions,thrdthllspvdwthgdntntns,23,23
Those who sleep with dogs will rise with fleas,9,46,thosewhosleepwithdogswillrisewithfleas,thswhslpwthdgswllrswthfls,25,21
It is the empty can that makes the most noise,10,45,itistheemptycanthatmakesthemostnoise,tsthmptycnthtmksthmstns,23,22
It needs a Hundred Lies to cover a Single Lie,10,45,itneedsahundredliestocoverasinglelie,tndshndrdlstcvrsngll,20,25
One law for the rich and another for the poor,10,45,onelawfortherichandanotherforthepoor,nlwfrthrchndnthrfrthpr,22,23
If we are not back by dawn call the President,10,45,ifwearenotbackbydawncallthepresident,fwrntbckbydwncllthprsdnt,24,21
That which does not kill us makes us stronger,9,45,thatwhichdoesnotkillusmakesusstronger,thtwhchdsntkllsmkssstrngr,25,20
The grass is always greener on the other side,9,45,thegrassisalwaysgreenerontheotherside,thgrssslwysgrnrnththrsd,23,22
When the going gets tough the tough get going,9,45,whenthegoinggetstoughthetoughgetgoing,whnthgnggtstghthtghgtgng,24,21
Work expands so as to fill the time available,9,45,workexpandssoastofillthetimeavailable,wrkxpndssstfllthtmvlbl,22,23
A chain is only as strong as its weakest link,8,45,a chain isonlyasstrongasitsweakestlink, chn snlysstrngstswkstlnk,25,20
Cowards may die many times before their death,8,45,cowardsmaydiemanytimesbeforetheirdeath,cwrdsmydmnytmsbfrthrdth,23,22
The longest journey starts with a single step,8,45,thelongestjourneystartswithasinglestep,thlngstjrnystrtswthsnglstp,26,19
As you make your bed so you must lie upon it,11,44,asyoumakeyourbedsoyoumustlieuponit,symkyrbdsymstlpnt,17,27
It is an ill wind that blows no one any good,11,44,itisanillwindthatblowsnooneanygood,tsnllwndthtblwsnnnygd,21,23
If at first you do not succeed try try again,10,44,ifatfirstyoudonotsucceedtrytryagain,ftfrstydntsccdtrytrygn,22,22
If you want a thing done well do it yourself,10,44,ifyouwantathingdonewelldoityourself,fywntthngdnwlldtyrslf,21,23
Do not throw the baby out with the bathwater,9,44,donotthrowthebabyoutwiththebathwater,dntthrwthbbytwththbthwtr,24,20
Doubt is the beginning not the end of wisdom,9,44,doubtisthebeginningnottheendofwisdom,dbtsthbgnnngntthndfwsdm,23,21
It is the squeaky wheel that gets the grease,9,44,itisthesqueakywheelthatgetsthegrease,tsthsqkywhlthtgtsthgrs,22,22
The course of true love never did run smooth,9,44,thecourseoftrueloveneverdidrunsmooth,thcrsftrlvnvrddrnsmth,21,23
You have to separate the wheat from the chaf,9,44,youhavetoseparatethewheatfromthechaf,yhvtsprtthwhtfrmthchf,21,23
A nod is as good as a wink to a blind horse,12,43,anodisasgoodasawinktoablindhorse,ndssgdswnktblndhrs,18,25
Do not cross the bridge till you come to it,10,43,donotcrossthebridgetillyoucometoit,dntcrssthbrdgtllycmtt,21,22
Do not cut off your nose to spite your face,10,43,donotcutoffyournosetospiteyourface,dntctffyrnstsptyrfc,19,24
A prophet is not recognized in his own land,9,43,aprophetisnotrecognizedinhisownland,prphtsntrcgnzdnhswnlnd,22,21
One who believes in Sword dies by the Sword,9,43,onewhobelievesinsworddiesbythesword,nwhblvsnswrddsbythswrd,22,21
You pay your money and you take your choice,9,43,youpayyourmoneyandyoutakeyourchoice,ypyyrmnyndytkyrchc,18,25
Music has charms to soothe the savage beast,8,43,musichascharmstosoothethesavagebeast,mschschrmstsththsvgbst,22,21
Imitation is the sincerest form of flattery,7,43,imitationisthesincerestformofflattery,mttnsthsncrstfrmfflttry,23,20
A house divided against itself cannot stand,5,43,a house dividedagainstitselfcannotstand, hs dvddgnsttslfcnntstnd,24,19
All work and no play makes Jack a dull boy,10,42,allworkandnoplaymakesjackadullboy,llwrkndnplymksjckdllby,22,20
Eat drink and be merry for tomorrow we die,9,42,eatdrinkandbemerryfortomorrowwedie,tdrnkndbmrryfrtmrrwwd,21,21
Do not teach your Grandmother to suck eggs,8,42,donotteachyourgrandmothertosuckeggs,dnttchyrgrndmthrtsckggs,23,19
Walnuts and pears you plant for your heirs,8,42,walnutsandpearsyouplantforyourheirs,wlntsndprsyplntfryrhrs,22,20
Fish always stinks from the head downwards,7,42,fishalwaysstinksfromtheheaddownwards,fshlwysstnksfrmthhddwnwrds,26,16
A man who is his own lawyer has a fool for his client,13,41,amanwhoishisownlawyerhasafoolforhisclient,mnwhshswnlwyrhsflfrhsclnt,25,16
A person is known by the company he keeps,9,41,apersonisknownbythecompanyhekeeps,prsnsknwnbythcmpnyhkps,22,19
The proof of the pudding is in the eating,9,41,theproofofthepuddingisintheeating,thprffthpddngsnthtng,20,21
He that goes a-borrowing goes a-sorrowing,6,41,hethatgoesa-borrowinggoesa-sorrowing,hthtgs-brrwnggs-srrwng,22,19
Give him an inch and he will take a mile,10,40,givehimaninchandhewilltakeamile,gvhmnnchndhwlltkml,18,22
There is more than one way to skin a cat,10,40,thereismorethanonewaytoskinacat,thrsmrthnnwytsknct,18,22
A little of what you fancy does you good,9,40,alittleofwhatyoufancydoesyougood,lttlfwhtyfncydsygd,18,22
You cannot have your cake and eat it too,9,40,youcannothaveyourcakeandeatittoo,ycnnthvyrckndttt,16,24
Fools rush in where angels fear to tread,8,40,foolsrushinwhereangelsfeartotread,flsrshnwhrnglsfrttrd,20,20
The bigger they are the harder they fall,8,40,thebiggertheyarethehardertheyfall,thbggrthyrthhrdrthyfll,22,18
The darkest hour is just before the dawn,8,40,thedarkesthourisjustbeforethedawn,thdrksthrsjstbfrthdwn,21,19
If wishes were horses beggars would ride,7,40,ifwisheswerehorsesbeggarswouldride,fwshswrhrssbggrswldrd,21,19
The cobbler always wears the worst shoes,7,40,thecobbleralwayswearstheworstshoes,thcbblrlwyswrsthwrstshs,23,17
Check yourself before you wreck yourself,6,40,checkyourselfbeforeyouwreckyourself,chckyrslfbfrywrckyrslf,22,18
Laugh before breakfast cry before supper,6,40,laughbeforebreakfastcrybeforesupper,lghbfrbrkfstcrybfrsppr,22,18
Do not try to walk before you can crawl,9,39,donottrytowalkbeforeyoucancrawl,dnttrytwlkbfrycncrwl,20,19
It is the early bird that gets the worm,9,39,itistheearlybirdthatgetstheworm,tsthrlybrdthtgtsthwrm,21,18
Never let the sun go down on your anger,9,39,neverletthesungodownonyouranger,nvrltthsngdwnnyrngr,19,20
When the cat is away the mice will play,9,39,whenthecatisawaythemicewillplay,whnthctswythmcwllply,20,19
Into every life a little rain must fall,8,39,intoeverylifealittlerainmustfall,ntvrylflttlrnmstfll,19,20
The apple never falls far from the tree,8,39,theappleneverfallsfarfromthetree,thpplnvrfllsfrfrmthtr,21,18
There is no such thing as bad publicity,8,39,thereisnosuchthingasbadpublicity,thrsnschthngsbdpblcty,21,18
A volunteer is worth twenty pressed men,7,39,avolunteerisworthtwentypressedmen,vlntrswrthtwntyprssdmn,22,17
Discretion is the better part of valour,7,39,discretionisthebetterpartofvalour,dscrtnsthbttrprtfvlr,20,19
Live for today for tomorrow never comes,7,39,livefortodayfortomorrownevercomes,lvfrtdyfrtmrrwnvrcms,20,19
With a responsibility comes great power,6,39,witharesponsibilitycomesgreatpower,wthrspnsbltycmsgrtpwr,21,18
A little knowledge is a dangerous thing,5,39,alittle knowledge isadangerousthing,lttl knwldg sdngrsthng,22,17
Do not put all your eggs in one basket,9,38,donotputallyoureggsinonebasket,dntptllyrggsnnbskt,18,20
See no evil hear no evil speak no evil,9,38,seenoevilhearnoevilspeaknoevil,snvlhrnvlspknvl,15,23
There is no such thing as a free lunch,9,38,thereisnosuchthingasafreelunch,thrsnschthngsfrlnch,19,19
There is no such thing as a free lunch,9,38,thereisnosuchthingasafreelunch,thrsnschthngsfrlnch,19,19
Do not let the bastards grind you down,8,38,donotletthebastardsgrindyoudown,dntltthbstrdsgrndydwn,21,17
Do not wash your dirty linen in public,8,38,donotwashyourdirtylineninpublic,dntwshyrdrtylnnnpblc,20,18
The husband is always the last to know,8,38,thehusbandisalwaysthelasttoknow,thhsbndslwysthlsttknw,21,17
You cannot teach an old dog new tricks,8,38,youcannotteachanolddognewtricks,ycnnttchnlddgnwtrcks,20,18
A poor workman always blames his tools,7,38,apoorworkmanalwaysblameshistools,prwrkmnlwysblmshstls,20,18
Fish and guests smell after three days,7,38,fishandguestssmellafterthreedays,fshndgstssmllftrthrdys,22,16
If life deals you lemons make lemonade,7,38,iflifedealsyoulemonsmakelemonade,flfdlsylmnsmklmnd,17,21
Nothing is certain but death and taxes,7,38,nothingiscertainbutdeathandtaxes,nthngscrtnbtdthndtxs,20,18
First impressions are the most lasting,6,38,firstimpressionsarethemostlasting,frstmprssnsrthmstlstng,22,16
Do not look a gift horse in the mouth,9,37,donotlookagifthorseinthemouth,dntlkgfthrsnthmth,17,20
Do not make a mountain of a mole hill,9,37,donotmakeamountainofamolehill,dntmkmntnfmlhll,15,22
It is easy to be wise after the event,9,37,itiseasytobewiseaftertheevent,tssytbwsftrthvnt,16,21
Let not the sun go down on your wrath,9,37,letnotthesungodownonyourwrath,ltntthsngdwnnyrwrth,19,18
You can have too much of a good thing,9,37,youcanhavetoomuchofagoodthing,ycnhvtmchfgdthng,16,21
There are always more fish in the sea,8,37,therearealwaysmorefishinthesea,thrrlwysmrfshnths,17,20
Children should be seen and not heard,7,37,childrenshouldbeseenandnotheard,chldrnshldbsnndnthrd,20,17
Cut your coat according to your cloth,7,37,cutyourcoataccordingtoyourcloth,ctyrctccrdngtyrclth,19,18
Money earned by deceit goes by deceit,7,37,moneyearnedbydeceitgoesbydeceit,mnyrndbydctgsbydct,18,19
The leopard does not change his spots,7,37,theleoparddoesnotchangehisspots,thlprddsntchnghsspts,20,17
There are two sides to every question,7,37,therearetwosidestoeveryquestion,thrrtwsdstvryqstn,17,20
April showers bring forth May flowers,6,37,aprilshowersbringforthmayflowers,prlshwrsbrngfrthmyflwrs,23,14
A drowning man will clutch at a straw,5,37,a drowning manwillclutchata straw, drwnng mnwllcltcht strw,24,13
In the midst of life we are in death,9,36,inthemidstoflifeweareindeath,nthmdstflfwrndth,16,20
Where there is a will there is a way,9,36,wherethereisawillthereisaway,whrthrswllthrswy,16,20
All good things come to he who waits,8,36,allgoodthingscometohewhowaits,llgdthngscmthwhwts,18,18
An apple a day keeps the doctor away,8,36,anappleadaykeepsthedoctoraway,nppldykpsthdctrwy,17,19
Beauty is in the eye of the beholder,8,36,beautyisintheeyeofthebeholder,btysnthyfthbhldr,16,20
Do not put the cart before the horse,8,36,donotputthecartbeforethehorse,dntptthcrtbfrthhrs,18,18
Do not put new wine into old bottles,8,36,donotputnewwineintooldbottles,dntptnwwnntldbttls,18,18
He who pays the piper calls the tune,8,36,hewhopaysthepipercallsthetune,hwhpysthpprcllsthtn,19,17
It is better to give than to receive,8,36,itisbettertogivethantoreceive,tsbttrtgvthntrcv,16,20
Never look a gift horse in the mouth,8,36,neverlookagifthorseinthemouth,nvrlkgfthrsnthmth,17,19
You cannot judge a book by its cover,8,36,youcannotjudgeabookbyitscover,ycnntjdgbkbytscvr,17,19
A good beginning makes a good ending,7,36,agoodbeginningmakesagoodending,gdbgnnngmksgdndng,17,19
A problem shared is a problem halved,7,36,aproblemsharedisaproblemhalved,prblmshrdsprblmhlvd,19,17
A trouble shared is a trouble halved,7,36,atroublesharedisatroublehalved,trblshrdstrblhlvd,17,19
Do not cast your pearls before swine,7,36,donotcastyourpearlsbeforeswine,dntcstyrprlsbfrswn,18,18
What cannot be cured must be endured,7,36,whatcannotbecuredmustbeendured,whtcnntbcrdmstbndrd,19,17
Necessity is the mother of invention,6,36,necessityisthemotherofinvention,ncsstysthmthrfnvntn,19,17
Possession is nine tenths of the law,7,36,possessionisninetenthsofthelaw,pssssnsnntnthsfthlw,19,17
Procrastination is the thief of time,6,36,procrastinationisthethiefoftime,prcrstntnsththfftm,18,18
You cannot make bricks without straw,6,36,youcannotmakebrickswithoutstraw,ycnntmkbrckswthtstrw,20,16
All good things must come to an end,8,35,allgoodthingsmustcometoanend,llgdthngsmstcmtnnd,18,17
All is grist that comes to the mill,8,35,allisgristthatcomestothemill,llsgrstthtcmstthmll,19,16
Do not bite the hand that feeds you,8,35,donotbitethehandthatfeedsyou,dntbtthhndthtfdsy,17,18
Do not keep a dog and bark yourself,8,35,donotkeepadogandbarkyourself,dntkpdgndbrkyrslf,17,18
Half a loaf is better than no bread,8,35,halfaloafisbetterthannobread,hlflfsbttrthnnbrd,17,18
It is no use crying over spilt milk,8,35,itisnousecryingoverspiltmilk,tsnscryngvrspltmlk,18,17
Never cast a clout until May be out,8,35,nevercastacloutuntilmaybeout,nvrcstcltntlmybt,16,19
Two is company but three is a crowd,8,35,twoiscompanybutthreeisacrowd,twscmpnybtthrscrwd,18,17
You cannot get blood out of a stone,8,35,youcannotgetbloodoutofastone,ycnntgtbldtfstn,15,20
A picture is worth a thousand words,7,35,apictureisworthathousandwords,pctrswrththsndwrds,18,17
Do not burn your bridges behind you,7,35,donotburnyourbridgesbehindyou,dntbrnyrbrdgsbhndy,18,17
Failing to plan is planning to fail,7,35,failingtoplanisplanningtofail,flngtplnsplnnngtfl,18,17
Hard work never did anyone any harm,7,35,hardworkneverdidanyoneanyharm,hrdwrknvrddnynnyhrm,19,16
There is an exception to every rule,7,35,thereisanexceptiontoeveryrule,thrsnxcptntvryrl,16,19
Absence makes the heart grow fonder,6,35,absencemakestheheartgrowfonder,bsncmksthhrtgrwfndr,19,16
Mighty oaks from little acorns grow,6,35,mightyoaksfromlittleacornsgrow,mghtyksfrmlttlcrnsgrw,21,14
The exception which proves the rule,6,35,theexceptionwhichprovestherule,thxcptnwhchprvsthrl,19,16
The squeaking wheel gets the grease,6,35,thesqueakingwheelgetsthegrease,thsqkngwhlgtsthgrs,18,17
Give a dog a bad name and hang him,9,34,giveadogabadnameandhanghim,gvdgbdnmndhnghm,15,19
It takes all sorts to make a world,8,34,ittakesallsortstomakeaworld,ttksllsrtstmkwrld,17,17
Many a true word is spoken in jest,8,34,manyatruewordisspokeninjest,mnytrwrdsspknnjst,17,17
The child is the father of the man,8,34,thechildisthefatheroftheman,thchldsthfthrfthmn,18,16
Attack is the best form of defense,7,34,attackisthebestformofdefense,ttcksthbstfrmfdfns,18,16
Good things come to those who wait,7,34,goodthingscometothosewhowait,gdthngscmtthswhwt,17,17
If you pay peanuts you get monkeys,7,34,ifyoupaypeanutsyougetmonkeys,fypypntsygtmnkys,16,18
Memory is the treasure of the mind,7,34,memoryisthetreasureofthemind,mmrysthtrsrfthmnd,17,17
One swallow does not make a summer,7,34,oneswallowdoesnotmakeasummer,nswllwdsntmksmmr,16,18
Put your money where your mouth is,7,34,putyourmoneywhereyourmouthis,ptyrmnywhryrmths,16,18
Revenge is a dish best served cold,7,34,revengeisadishbestservedcold,rvngsdshbstsrvdcld,18,16
Speak softly and carry a big stick,7,34,speaksoftlyandcarryabigstick,spksftlyndcrrybgstck,20,14
The best defence is a good offence,7,34,thebestdefenceisagoodoffence,thbstdfncsgdffnc,16,18
The labourer is worthy of his hire,7,34,thelabourerisworthyofhishire,thlbrrswrthyfhshr,17,17
The pen is mightier than the sword,7,34,thepenismightierthanthesword,thpnsmghtrthnthswrd,19,15
Where there is muck there is brass,7,34,wherethereismuckthereisbrass,whrthrsmckthrsbrss,18,16
Everything comes to those who wait,6,34,everythingcomestothosewhowait,vrythngcmstthswhwt,18,16
Worrying never did anyone any good,6,34,worryingneverdidanyoneanygood,wrryngnvrddnynnygd,18,16
Absolute power corrupts absolutely,4,34,absolutepowercorruptsabsolutely,bsltpwrcrrptsbsltly,19,15
Adversity makes strange bedfellows,4,34,adversitymakesstrangebedfellows,dvrstymksstrngbdfllws,21,13
It is best to be on the safe side,9,33,itisbesttobeonthesafeside,tsbsttbnthsfsd,14,19
It takes a thief to catch a thief,8,33,ittakesathieftocatchathief,ttksthftctchthf,15,18
There is no fool like an old fool,8,33,thereisnofoollikeanoldfool,thrsnfllknldfl,14,19
All things come to those who wait,7,33,allthingscometothosewhowait,llthngscmtthswhwt,17,16
Ask no questions and hear no lies,7,33,asknoquestionsandhearnolies,sknqstnsndhrnls,15,18
If you cannot beat them join them,7,33,ifyoucannotbeatthemjointhem,fycnntbtthmjnthm,16,17
Jack of all trades master of none,7,33,jackofalltradesmasterofnone,jckflltrdsmstrfnn,17,16
Jack of all trades master of some,7,33,jackofalltradesmasterofsome,jckflltrdsmstrfsm,17,16
Life is not all beer and skittles,7,33,lifeisnotallbeerandskittles,lfsntllbrndskttls,17,16
Never give a sucker an even break,7,33,nevergiveasuckeranevenbreak,nvrgvsckrnvnbrk,15,18
Respect is not given it is earned,7,33,respectisnotgivenitisearned,rspctsntgvntsrnd,16,17
Spare the rod and spoil the child,7,33,sparetherodandspoilthechild,sprthrdndsplthchld,18,15
There is no time like the present,7,33,thereisnotimelikethepresent,thrsntmlkthprsnt,16,17
To err is human to forgive divine,7,33,toerrishumantoforgivedivine,trrshmntfrgvdvn,15,18
While there is life there is hope,7,33,whilethereislifethereishope,whlthrslfthrshp,15,18
Birds of a feather flock together,6,33,birdsofafeatherflocktogether,brdsffthrflcktgthr,18,15
Do not change horses in midstream,6,33,donotchangehorsesinmidstream,dntchnghrssnmdstrm,18,15
Empty vessels make the most noise,6,33,emptyvesselsmakethemostnoise,mptyvsslsmkthmstns,18,15
There is no accounting for tastes,6,33,thereisnoaccountingfortastes,thrsnccntngfrtsts,17,16
Little things please little minds,5,33,littlethingspleaselittleminds,lttlthngsplslttlmnds,20,13
Hindsight is always twenty twenty,5,33,hindsightisalwaystwentytwenty,hndsghtslwystwntytwnty,22,11
When in Rome do as the Romans do,8,32,wheninromedoastheromansdo,whnnrmdsthrmnsd,15,17
Ask my companion if I be a thief,8,32,askmycompanionifibeathief,skmycmpnnfbthf,14,18
Faint heart never won fair lady ,6,32,faintheartneverwonfairlady,fnthrtnvrwnfrldy,16,16
If anything can go wrong it will,7,32,ifanythingcangowrongitwill,fnythngcngwrngtwll,18,14
If you cannot be good be careful,7,32,ifyoucannotbegoodbecareful,fycnntbgdbcrfl,14,18
Jack of all trades master of one,7,32,jackofalltradesmasterofone,jckflltrdsmstrfn,16,16
Man does not live by bread alone,7,32,mandoesnotlivebybreadalone,mndsntlvbybrdln,15,17
The best things in life are free,7,32,thebestthingsinlifearefree,thbstthngsnlfrfr,16,16
The longest day must have an end,7,32,thelongestdaymusthaveanend,thlngstdymsthvnnd,17,15
The moon is made of green cheese,7,32,themoonismadeofgreencheese,thmnsmdfgrnchs,14,18
You must have rocks in your head,7,32,youmusthaverocksinyourhead,ymsthvrcksnyrhd,15,17
A soft answer turneth away wrath,6,32,asoftanswerturnethawaywrath,sftnswrtrnthwywrth,18,14
Knowledge is power guard it well,6,32,knowledgeispowerguarditwell,knwldgspwrgrdtwll,17,15
Let the punishment fit the crime,6,32,letthepunishmentfitthecrime,ltthpnshmntftthcrm,18,14
Marry in haste repent at leisure,6,32,marryinhasterepentatleisure,mrrynhstrpnttlsr,16,16
Cleanliness is next to godliness,5,32,cleanlinessisnexttogodliness,clnlnsssnxttgdlnss,18,14
Good fences make good neighbours,5,32,goodfencesmakegoodneighbours,gdfncsmkgdnghbrs,16,16
A penny saved is a penny earned,7,31,apennysavedisapennyearned,pnnysvdspnnyrnd,15,16
It will come back and haunt you,7,31,itwillcomebackandhauntyou,twllcmbckndhnty,15,16
Judge not that ye be not judged,7,31,judgenotthatyebenotjudged,jdgntthtybntjdgd,16,15
Never judge a book by its cover,7,31,neverjudgeabookbyitscover,nvrjdgbkbytscvr,15,16
A rolling stone gathers no moss,6,31,arollingstonegathersnomoss,rllngstngthrsnmss,17,14
Christmas comes but once a year,6,31,christmascomesbutonceayear,chrstmscmsbtncyr,16,15
Every cloud has a silver lining,6,31,everycloudhasasilverlining,vrycldhsslvrlnng,16,15
Give credit where credit is due,6,31,givecreditwherecreditisdue,gvcrdtwhrcrdtsd,15,16
Money makes the world go around,6,31,moneymakestheworldgoaround,mnymksthwrldgrnd,16,15
The early bird catches the worm,6,31,theearlybirdcatchestheworm,thrlybrdctchsthwrm,18,13
Actions speak louder than words,5,31,actionsspeaklouderthanwords,ctnsspkldrthnwrds,17,14
Any publicity is good publicity,5,31,anypublicityisgoodpublicity,nypblctysgdpblcty,17,14
Nothing ventured nothing gained,4,31,nothingventurednothinggained,nthngvntrdnthnggnd,18,13
An army marches on its stomach,6,30,anarmymarchesonitsstomach,nrmymrchsntsstmch,17,13
Opportunity never knocks twice,4,30,opportunityneverknockstwice,pprtntynvrknckstwc,18,12
Beware of Greeks bearing gifts,5,30,bewareofgreeksbearinggifts,bwrfgrksbrnggfts,16,14
Feed a cold and starve a fever,7,30,feedacoldandstarveafever,fdcldndstrvfvr,14,16
There is nowt so queer as folk,7,30,thereisnowtsoqueerasfolk,thrsnwtsqrsflk,14,16
Two blacks do not make a white,7,30,twoblacksdonotmakeawhite,twblcksdntmkwht,15,15
Two wrongs do not make a right,7,30,twowrongsdonotmakearight,twwrngsdntmkrght,16,14
You are never too old to learn,7,30,youarenevertoooldtolearn,yrnvrtldtlrn,12,18
He who laughs last laughs best,6,30,hewholaughslastlaughsbest,hwhlghslstlghsbst,17,13
Late lunch makes day go faster,6,30,latelunchmakesdaygofaster,ltlnchmksdygfstr,16,14
Love makes the world go around,6,30,lovemakestheworldgoaround,lvmksthwrldgrnd,15,15
Never tell tales out of school,6,30,nevertelltalesoutofschool,nvrtlltlstfschl,15,15
There is no smoke without fire,6,30,thereisnosmokewithoutfire,thrsnsmkwthtfr,14,16
There is one born every minute,6,30,thereisoneborneveryminute,thrsnbrnvrymnt,14,16
Too many cooks spoil the broth,6,30,toomanycooksspoilthebroth,tmnyckssplthbrth,16,14
Beggars should not be choosers,5,30,beggarsshouldnotbechoosers,bggrsshldntbchsrs,17,13
Little strokes fell great oaks,5,30,littlestrokesfellgreatoaks,lttlstrksfllgrtks,17,13
One good turn deserves another,5,30,onegoodturndeservesanother,ngdtrndsrvsnthr,15,15
Prevention is better than cure,5,30,preventionisbetterthancure,prvntnsbttrthncr,16,14
Truth is stranger than fiction,5,30,truthisstrangerthanfiction,trthsstrngrthnfctn,18,12
A golden key can open any door,4,30,agolden key canopenany door,gldn ky cnpnny dr,17,13
Finders keepers losers weepers,4,30,finderskeeperslosersweepers,fndrskprslsrswprs,17,13
Variety is the spice of life ,6,29,varietyisthespiceoflife ,vrtysthspcflf ,14,15
A change is as good as a rest,8,29,achangeisasgoodasarest,chngssgdsrst,12,17
In for a penny in for a pound,8,29,inforapennyinforapound,nfrpnnynfrpnd,13,16
East is east and west is west,7,29,eastiseastandwestiswest,stsstndwstswst,14,15
Time and tide wait for no man,7,29,timeandtidewaitfornoman,tmndtdwtfrnmn,13,16
A rising tide lifts all boats,6,29,arisingtideliftsallboats,rsngtdlftsllbts,15,14
All that glitters is not gold,6,29,allthatglittersisnotgold,llthtglttrssntgld,17,12
Better wear out than rust out,6,29,betterwearoutthanrustout,bttrwrtthnrstt,14,15
Make hay while the sun shines,6,29,makehaywhilethesunshines,mkhywhlthsnshns,15,14
Slow and steady wins the race,6,29,slowandsteadywinstherace,slwndstdywnsthrc,16,13
Two heads are better than one,6,29,twoheadsarebetterthanone,twhdsrbttrthnn,14,15
Do not meet troubles half-way,5,29,donotmeettroubleshalf-way,dntmttrblshlf-wy,16,13
Fact is stranger than fiction,5,29,factisstrangerthanfiction,fctsstrngrthnfctn,17,12
Fine words butter no parsnips,5,29,finewordsbutternoparsnips,fnwrdsbttrnprsnps,17,12
Flattery will get you nowhere,5,29,flatterywillgetyounowhere,flttrywllgtynwhr,16,13
Laughter is the best medicine,5,29,laughteristhebestmedicine,lghtrsthbstmdcn,15,14
Little pitchers have big ears,5,29,littlepitchershavebigears,lttlptchrshvbgrs,16,13
There is honour among thieves,5,29,thereishonouramongthieves,thrshnrmngthvs,14,15
What goes around comes around,5,29,whatgoesaroundcomesaround,whtgsrndcmsrnd,14,15
Nothing succeeds like success,4,29,nothingsucceedslikesuccess,nthngsccdslksccss,17,12
A word to the wise is enough,7,28,awordtothewiseisenough,wrdtthwssngh,12,16
As you sow so shall you reap,7,28,asyousowsoshallyoureap,syswsshllyrp,12,16
Enough is as good as a feast,7,28,enoughisasgoodasafeast,nghssgdsfst,11,17
Set a thief to catch a thief,7,28,setathieftocatchathief,stthftctchthf,13,15
The boy is father to the man,7,28,theboyisfathertotheman,thbysfthrtthmn,14,14
Do not throw pearls to swine,6,28,donotthrowpearlstoswine,dntthrwprlstswn,15,13
Many a little makes a mickle,6,28,manyalittlemakesamickle,mnylttlmksmckl,14,14
Many a mickle makes a muckle,6,28,manyamicklemakesamuckle,mnymcklmksmckl,14,14
Money does not grow on trees,6,28,moneydoesnotgrowontrees,mnydsntgrwntrs,14,14
No man can serve two masters,6,28,nomancanservetwomasters,nmncnsrvtwmstrs,15,13
Strike while the iron is hot,6,28,strikewhiletheironishot,strkwhlthrnsht,14,14
Youth is wasted on the young,6,28,youthiswastedontheyoung,ythswstdnthyng,14,14
Handsome is as handsome does,5,28,handsomeisashandsomedoes,hndsmsshndsmds,14,14
Marriages are made in heaven,5,28,marriagesaremadeinheaven,mrrgsrmdnhvn,12,16
Penny wise and pound foolish,5,28,pennywiseandpoundfoolish,pnnywsndpndflsh,15,13
The customer is always right,5,28,thecustomerisalwaysright,thcstmrslwysrght,16,12
Softly softly catchee monkey,4,28,softlysoftlycatcheemonkey,sftlysftlyctchmnky,18,10
A miss is as good as a mile,8,27,amissisasgoodasamile,mssssgdsml,10,17
All is fair in love and war,7,27,allisfairinloveandwar,llsfrnlvndwr,12,15
Brevity is the soul of wit ,6,27,brevityisthesoulofwit,brvtysthslfwt,13,14
It is all grist to the mill,7,27,itisallgristtothemill,tsllgrsttthmll,14,13
Let the dead bury the dead ,6,27,letthedeadburythedead,ltthddbrythdd,13,14
Rome was not built in a day,7,27,romewasnotbuiltinaday,rmwsntbltndy,12,15
A stitch in time saves nine,6,27,astitchintimesavesnine,sttchntmsvsnn,13,14
All the world loves a lover,6,27,alltheworldlovesalover,llthwrldlvslvr,14,13
It never rains but it pours,6,27,itneverrainsbutitpours,tnvrrnsbttprs,13,14
Never speak ill of the dead,6,27,neverspeakillofthedead,nvrspkllfthdd,13,14
Once a witch always a witch,6,27,onceawitchalwaysawitch,ncwtchlwyswtch,14,13
Once a thief always a thief,6,27,onceathiefalwaysathief,ncthflwysthf,12,15
The age of miracles is past,6,27,theageofmiraclesispast,thgfmrclsspst,13,14
There is no place like home,6,27,thereisnoplacelikehome,thrsnplclkhm,12,15
To the victor go the spoils,6,27,tothevictorgothespoils,tthvctrgthspls,14,13
What goes up must come down,6,27,whatgoesupmustcomedown,whtgspmstcmdwn,14,13
Blood is thicker than water,5,27,bloodisthickerthanwater,bldsthckrthnwtr,15,12
Do not upset the apple cart,6,27,donotupsettheapplecart,dntpstthpplcrt,14,13
Every picture tells a story,5,27,everypicturetellsastory,vrypctrtllsstry,15,12
Fair exchange is no robbery,5,27,fairexchangeisnorobbery,frxchngsnrbbry,14,13
Shiny are the distant hills,5,27,shinyarethedistanthills,shnyrthdstnthlls,16,11
The end justifies the means,5,27,theendjustifiesthemeans,thndjstfsthmns,14,13
Familiarity breeds contempt,3,27,familiaritybreedscontempt,fmlrtybrdscntmpt,16,11
A good man is hard to find,7,26,agoodmanishardtofind,gdmnshrdtfnd,12,14
Do as you would be done by,7,26,doasyouwouldbedoneby,dsywldbdnby,11,15
All is well that ends well,6,26,alliswellthatendswell,llswllthtndswll,15,11
Do not cry over spilt milk,6,26,donotcryoverspiltmilk,dntcryvrspltmlk,15,11
Home is where the heart is,6,26,homeiswheretheheartis,hmswhrthhrts,12,14
Honesty is the best policy,5,26,honestyisthebestpolicy,hnstysthbstplcy,15,11
Many hands make light work,5,26,manyhandsmakelightwork,mnyhndsmklghtwrk,16,10
Only fools and horses work,5,26,onlyfoolsandhorseswork,nlyflsndhrsswrk,15,11
Put your best foot forward,5,26,putyourbestfootforward,ptyrbstftfrwrd,14,12
There is safety in numbers,5,26,thereissafetyinnumbers,thrssftynnmbrs,14,12
Another day another dollar,4,26,anotherdayanotherdollar,nthrdynthrdllr,14,12
It is like juggling sand ,5,25,itislikejugglingsand,tslkjgglngsnd,13,12
Fake it until you make it,6,25,fakeituntilyoumakeit,fktntlymkt,10,15
Pride goes before a fall ,5,25,pridegoesbeforeafall,prdgsbfrfll,11,14
A watched pot never boils,5,25,awatchedpotneverboils,wtchdptnvrbls,13,12
One hand washes the other,5,25,onehandwashestheother,nhndwshsththr,13,12
Right or wrong my country,5,25,rightorwrongmycountry,rghtrwrngmycntry,16,9
Careless talk costs lives,4,25,carelesstalkcostslives,crlsstlkcstslvs,15,10
Faith will move mountains,4,25,faithwillmovemountains,fthwllmvmntns,13,12
Fortune favours the brave,4,25,fortunefavoursthebrave,frtnfvrsthbrv,13,12
Least said soonest mended,4,25,leastsaidsoonestmended,lstsdsnstmndd,13,12
It takes one to know one,6,24,ittakesonetoknowone,ttksntknwn,10,14
Life is what you make it,6,24,lifeiswhatyoumakeit,lfswhtymkt,10,14
Oil and water do not mix,6,24,oilandwaterdonotmix,lndwtrdntmx,11,13
Out of sight out of mind,6,24,outofsightoutofmind,tfsghttfmnd,11,13
Penny Penny  Makes many ,4,24,pennypennymakesmany,pnnypnnymksmny,14,10
Beauty is only skin deep,5,24,beautyisonlyskindeep,btysnlyskndp,12,12
Big fish eat little fish,5,24,bigfisheatlittlefish,bgfshtlttlfsh,13,11
Every stick has two ends,5,24,everystickhastwoends,vrystckhstwnds,14,10
Good talk saves the food,5,24,goodtalksavesthefood,gdtlksvsthfd,12,12
He who hesitates is lost,5,24,hewhohesitatesislost,hwhhsttsslst,12,12
Stupid is as stupid does,5,24,stupidisasstupiddoes,stpdssstpdds,12,12
Barking dogs seldom bite,4,24,barkingdogsseldombite,brkngdgssldmbt,14,10
Curiosity killed the cat,4,24,curiositykilledthecat,crstyklldthct,13,11
Moderation in all things,4,24,moderationinallthings,mdrtnnllthngs,13,11
Practice what you preach,4,24,practicewhatyoupreach,prctcwhtyprch,13,11
Wonders will never cease,4,24,wonderswillnevercease,wndrswllnvrcs,13,11
Business before pleasure,3,24,businessbeforepleasure,bsnssbfrplsr,12,12
Do as I say not as I do,8,23,doasisaynotasido,dssyntsd,8,15
If the cap fits wear it,6,23,ifthecapfitswearit,fthcpftswrt,11,12
Every Jack has his Jill,5,23,everyjackhashisjill,vryjckhshsjll,13,10
Every man has his price,5,23,everymanhashisprice,vrymnhshsprc,12,11
Hard cases make bad law,5,23,hardcasesmakebadlaw,hrdcssmkbdlw,12,11
Nine tailors make a man,5,23,ninetailorsmakeaman,nntlrsmkmn,10,13
You cannot win them all,5,23,youcannotwinthemall,ycnntwnthmll,12,11
First come first served,4,23,firstcomefirstserved,frstcmfrstsrvd,14,9
Great minds think alike,4,23,greatmindsthinkalike,grtmndsthnklk,13,10
Money is not everything,4,23,moneyisnoteverything,mnysntvrythng,13,10
Shrouds have no pockets,4,23,shroudshavenopockets,shrdshvnpckts,13,10
Tomorrow is another day,4,23,tomorrowisanotherday,tmrrwsnthrdy,12,11
Forewarned is forearmed,3,23,forewarnedisforearmed,frwrndsfrrmd,12,11
All roads lead to Rome,5,22,allroadsleadtorome,llrdsldtrm,10,12
Dead men tell no tales,5,22,deadmentellnotales,ddmntllntls,11,11
East west home is best,5,22,eastwesthomeisbest,stwsthmsbst,11,11
Every tide has its ebb,5,22,everytidehasitsebb,vrytdhstsbb,11,11
No rest for the wicked,5,22,norestforthewicked,nrstfrthwckd,12,10
Seek and ye shall find,5,22,seekandyeshallfind,skndyshllfnd,12,10
Time is a great healer,5,22,timeisagreathealer,tmsgrthlr,9,13
When it rains it pours,5,22,whenitrainsitpours,whntrnstprs,11,11
Better late than never,4,22,betterlatethannever,bttrltthnnvr,12,10
Better safe than sorry,4,22,bettersafethansorry,bttrsfthnsrry,13,9
Charity begins at home,4,22,charitybeginsathome,chrtybgnsthm,12,10
Every little bit helps,4,22,everylittlebithelps,vrylttlbthlps,13,9
It goes without saying,4,22,itgoeswithoutsaying,tgswthtsyng,11,11
Let bygones be bygones,4,22,letbygonesbebygones,ltbygnsbbygns,13,9
Nature abhors a vacuum,4,22,natureabhorsavacuum,ntrbhrsvcm,10,12
Accidents will happen ,3,22,accidentswillhappen,ccdntswllhppn,13,9
Comparisons are odious,3,22,comparisonsareodious,cmprsnsrds,10,12
History repeats itself,3,22,historyrepeatsitself,hstryrptstslf,13,9
Physician heal thyself,3,22,physicianhealthyself,physcnhlthyslf,14,8
Practice makes perfect,3,22,practicemakesperfect,prctcmksprfct,13,9
Even a worm will turn,5,21,evenawormwillturn,vnwrmwlltrn,11,10
Every dog has his day,5,21,everydoghashisday,vrydghshsdy,11,10
It takes two to tango,5,21,ittakestwototango,ttkstwttng,10,11
Third time is a charm,5,21,thirdtimeisacharm,thrdtmschrm,11,10
Bad news travels fast,4,21,badnewstravelsfast,bdnwstrvlsfst,13,8
Cold hands warm heart,4,21,coldhandswarmheart,cldhndswrmhrt,13,8
Let sleeping dogs lie,4,21,letsleepingdogslie,ltslpngdgsl,11,10
Loose lips sink ships,4,21,looselipssinkships,lslpssnkshps,12,9
More haste less speed,4,21,morehastelessspeed,mrhstlssspd,11,10
Once bitten twice shy,4,21,oncebittentwiceshy,ncbttntwcshy,12,9
Still waters run deep,4,21,stillwatersrundeep,stllwtrsrndp,12,9
A house is not a home,3,21,a house isnota home, hs snt hm,10,11
Keep your powder dry,4,20,keepyourpowderdry,kpyrpwdrdry,11,9
All you need is love,5,20,allyouneedislove,llyndslv,8,12
Do not rock the boat,5,20,donotrocktheboat,dntrckthbt,10,10
It is never too late,5,20,itisnevertoolate,tsnvrtlt,8,12
Love will find a way,5,20,lovewillfindaway,lvwllfndwy,10,10
No news is good news,5,20,nonewsisgoodnews,nnwssgdnws,10,10
You are what you eat,5,20,youarewhatyoueat,yrwhtyt,7,13
All things must pass,4,20,allthingsmustpass,llthngsmstpss,13,7
Clothes make the man,4,20,clothesmaketheman,clthsmkthmn,11,9
Fight fire with fire,4,20,fightfirewithfire,fghtfrwthfr,11,9
Let the buyer beware,4,20,letthebuyerbeware,ltthbyrbwr,10,10
Life begins at forty,4,20,lifebeginsatforty,lfbgnstfrty,11,9
Like father like son,4,20,likefatherlikeson,lkfthrlksn,10,10
Look before you leap,4,20,lookbeforeyouleap,lkbfrylp,8,12
Patience is a virtue,4,20,patienceisavirtue,ptncsvrt,8,12
The more the merrier,4,20,themorethemerrier,thmrthmrrr,10,10
Cheats never prosper,3,20,cheatsneverprosper,chtsnvrprspr,12,8
Count your blessings,3,20,countyourblessings,cntyrblssngs,12,8
Hope springs eternal,3,20,hopespringseternal,hpsprngstrnl,12,8
Misery loves company,3,20,miserylovescompany,msrylvscmpny,12,8
Tomorrow never comes,3,20,tomorrownevercomes,tmrrwnvrcms,11,9
Any port in a storm,5,19,anyportinastorm,nyprtnstrm,10,9
No man is an island,5,19,nomanisanisland,nmnsnslnd,9,10
Never say never[34],3,19,neversaynever[34],nvrsynvr[34],12,7
Seeing is believing,3,19,seeingisbelieving,sngsblvng,9,10
Crime does not pay,4,18,crimedoesnotpay,crmdsntpy,9,9
Let your hair down,4,18,letyourhairdown,ltyrhrdwn,9,9
The good die young,4,18,thegooddieyoung,thgddyng,8,10
Waste not want not,4,18,wastenotwantnot,wstntwntnt,10,8
First things first,3,18,firstthingsfirst,frstthngsfrst,13,5
Horses for courses,3,18,horsesforcourses,hrssfrcrss,10,8
Manners maketh man,3,18,mannersmakethman,mnnrsmkthmn,11,7
Boys will be boys,4,17,boyswillbeboys,byswllbbys,10,7
Easy come easy go,4,17,easycomeeasygo,sycmsyg,7,10
Keep your chin up,4,17,keepyourchinup,kpyrchnp,8,9
Live and let live,4,17,liveandletlive,lvndltlv,8,9
Make love not war,4,17,makelovenotwar,mklvntwr,8,9
Speak as you find,4,17,speakasyoufind,spksyfnd,8,9
Haste makes waste,3,17,hastemakeswaste,hstmkswst,9,8
Might makes right,3,17,mightmakesright,mghtmksrght,11,6
Silence is golden,3,17,silenceisgolden,slncsgldn,9,8
No guts no glory,4,16,nogutsnoglory,ngtsnglry,9,7
Enough is enough,3,16,enoughisenough,nghsngh,7,9
Milking the bull,3,16,milkingthebull,mlkngthbll,10,6
Pearls of wisdom,3,16,pearlsofwisdom,prlsfwsdm,9,7
Revenge is sweet,3,16,revengeissweet,rvngsswt,8,8
Speech is silver,3,16,speechissilver,spchsslvr,9,7
No pain no gain,4,15,nopainnogain,npnngn,6,9
To each his own,4,15,toeachhisown,tchhswn,7,8
Free is for me,4,14,freeisforme,frsfrm,6,8
Let well alone,3,14,letwellalone,ltwllln,7,7
Might is right,3,14,mightisright,mghtsrght,9,5
Time will tell,3,14,timewilltell,tmwlltll,8,6
Truth will out,3,14,truthwillout,trthwllt,8,6
Love is blind,3,13,loveisblind,lvsblnd,7,6
Slow but sure,3,13,slowbutsure,slwbtsr,7,6
Talk is cheap,3,13,talkischeap,tlkschp,7,6
Time is money,3,13,timeismoney,tmsmny,6,7
Less is more,3,12,lessismore,lsssmr,6,6
Money talks,2,11,moneytalks,mnytlks,7,4
Time flies,2,10,timeflies,tmfls,5,5
It is on,3,8,itison,tsn,3,5
